*X*********X***X***X*
*X*XXXXXXX*X*XXX*XXX*
*****************X*X*
XX***XXXXXXXXX*XXX*X*
***X*X***************
XXXXX*****XXXXX*XXX**
*********X*****X*****
*XXXXXXXXX*XXXXXXXXX*
***X*****X*X*****X***
*X*X*X*XXX*X**XX*XXXX
*X***X*********X*****
